1111111111111111111111111
1E0000000000000C00000C001
1C10010100100000101001001
1010010010101010001001001
100000000000C00000P000001
1111111111111111111111111