111111111111111111111111
1C11101C1111C1111C000011
100000101111011111111011
1P0000100000000000000001
11111000001111C000000011
111111111000111110000001
1111C0000000000000000011
111111111C11111111110001
111111111111111111111101
111111111111111111111001
11C000000000000000000011
111111111111111011111111
1111111111E0000011111111
111111111111111111111111