1111111111111111111111111
1000110000C00000000011111
10000C0000000000110000011
1000111110110110110110111
1P001C0000C00000000000011
10001111111100000000E0011
1000000000000000000000011
100000111000000C000000011
100000111C000000000000011
1000000011111111110001111
1000000000000000000100111
1111000000000000000110111
10C0011111C0000111111C111
1111111111111111111111111