111111111111111111111111
1110000000000001000000E1
1000P1000000000100000001
100001000000000C00000001
111111111111111111111111